wwwwwwwwwwwwwwwwwwwwwwwww
w p                     w
wwwwwwwwwwwwwwwwwwwwwww w
w                       w
w wwwwwwwwwwwwwwwwwwwwwww
w                       w
wewwwwwwwewewewewewewew w
w                       w
wwwwwwwwwwwww wwwwwewweww
w     e        e        w
w     e           e     w
wwwwwwwwwwwwwwwwwwwwwww w
w  e e                  w
wwwwwwwww wwwwwwwwwwwwwww
w                       w
wwwwwwwwwwwwwwwwwwwwwww w
w                       w
w                     g w
w                       w
wwwwwwwwwwwwwwwwwwwwwwwww