wwwwwwwwwwwwwwwwwwwwwwwww
w p                     w
wwwwwwwwwwwwwwwwwww wwwww
w                       w
wwwwwwwwwwwwwwwwwww wwwww
w                       w
weww wwwwewewewewewewewww
w                       w
wwwwwwwwwwwww wwwwwewweww
w     e        e        w
w     e           e     w
wwwwwwwwwwwwwwwwww wwwwww
w  e e                  w
wwwwwwwww wwwwwwwwwwwwwww
w                       w
wwwwwwwwwwwwwwwwww wwwwww
w                       w
w                     g w
w                       w
wwwwwwwwwwwwwwwwwwwwwwwww